1111111
1P00111
11101E1
1C00101
1111111
1000001
1011101
1010001
1111111
