11111111111111
110000000001E1
1C000CCCP00001
11111111111111
