111111111111111
100000000000101
100000000000101
1E1C101010101P1
111111111111111
